111111111111111
1P00000000000C1
111110001111001
100000001000001
1000010000000E1
111111111111111